団体コード,都道府県名,市区町村名,開設局数_前回,開設局数_今回,開設局数_差分
80004,茨城県,,445,484,39
82015,茨城県,水戸市,39,41,2
82023,茨城県,日立市,56,57,1
82031,茨城県,土浦市,10,10,0
82040,茨城県,古河市,28,30,2
82074,茨城県,結城市,11,11,0
82082,茨城県,龍ケ崎市,3,3,0
82104,茨城県,下妻市,6,7,1
82112,茨城県,常総市,2,2,0
82147,茨城県,高萩市,6,6,0
82155,茨城県,北茨城市,5,6,1
82163,茨城県,笠間市,11,16,5
82171,茨城県,取手市,25,25,0
82198,茨城県,牛久市,5,6,1
82201,茨城県,つくば市,60,60,0
82210,茨城県,ひたちなか市,43,43,0
82228,茨城県,鹿嶋市,25,25,0
82244,茨城県,守谷市,13,13,0
82252,茨城県,常陸大宮市,6,6,0
82261,茨城県,那珂市,5,6,1
82279,茨城県,筑西市,15,20,5
82287,茨城県,坂東市,6,6,0
82295,茨城県,稲敷市,3,8,5
82309,茨城県,かすみがうら市,1,1,0
82317,茨城県,桜川市,7,7,0
82325,茨城県,神栖市,3,3,0
82333,茨城県,行方市,4,6,2
82341,茨城県,鉾田市,3,3,0
82350,茨城県,つくばみらい市,12,12,0
82368,茨城県,小美玉市,1,1,0
83020,茨城県,東茨城郡茨城町,4,5,1
83097,茨城県,東茨城郡大洗町,0,1,1
83101,茨城県,東茨城郡城里町,5,10,5
83411,茨城県,那珂郡東海村,3,3,0
83640,茨城県,久慈郡大子町,2,2,0
84425,茨城県,稲敷郡美浦村,2,2,0
84433,茨城県,稲敷郡阿見町,4,7,3
84476,茨城県,稲敷郡河内町,1,1,0
85421,茨城県,猿島郡五霞町,1,4,3
85464,茨城県,猿島郡境町,9,9,0
90000,栃木県,,237,270,33
92011,栃木県,宇都宮市,79,84,5
92029,栃木県,足利市,24,25,1
92037,栃木県,栃木市,0,4,4
92045,栃木県,佐野市,12,18,6
92053,栃木県,鹿沼市,32,32,0
92061,栃木県,日光市,3,5,2
92088,栃木県,小山市,41,42,1
92096,栃木県,真岡市,6,8,2
92100,栃木県,大田原市,11,11,0
92118,栃木県,矢板市,1,1,0
92134,栃木県,那須塩原市,5,6,1
92142,栃木県,さくら市,4,6,2
92151,栃木県,那須烏山市,5,7,2
92169,栃木県,下野市,1,1,0
93017,栃木県,河内郡上三川町,2,2,0
93441,栃木県,芳賀郡市貝町,3,3,0
93459,栃木県,芳賀郡芳賀町,1,1,0
93611,栃木県,下都賀郡壬生町,0,3,3
93645,栃木県,下都賀郡野木町,5,5,0
93866,栃木県,塩谷郡高根沢町,2,5,3
94072,栃木県,那須郡那須町,0,1,1
100005,群馬県,,269,309,40
102016,群馬県,前橋市,48,52,4
102024,群馬県,高崎市,64,69,5
102032,群馬県,桐生市,8,11,3
102041,群馬県,伊勢崎市,37,41,4
102059,群馬県,太田市,53,53,0
102067,群馬県,沼田市,6,6,0
102075,群馬県,館林市,8,10,2
102083,群馬県,渋川市,4,7,3
102091,群馬県,藤岡市,5,10,5
102105,群馬県,富岡市,2,2,0
102113,群馬県,安中市,3,6,3
102121,群馬県,みどり市,4,9,5
103446,群馬県,北群馬郡榛東村,1,1,0
103454,群馬県,北群馬郡吉岡町,2,2,0
104213,群馬県,吾妻郡中之条町,2,4,2
104256,群馬県,吾妻郡嬬恋村,0,1,1
104493,群馬県,利根郡みなかみ町,1,2,1
104647,群馬県,佐波郡玉村町,9,10,1
105210,群馬県,邑楽郡板倉町,1,1,0
105244,群馬県,邑楽郡大泉町,6,7,1
105252,群馬県,邑楽郡邑楽町,5,5,0
110001,埼玉県,,1458,1493,35
111015,埼玉県,さいたま市西区,21,22,1
111023,埼玉県,さいたま市北区,38,38,0
111031,埼玉県,さいたま市大宮区,49,51,2
111040,埼玉県,さいたま市見沼区,42,42,0
111058,埼玉県,さいたま市中央区,21,21,0
111066,埼玉県,さいたま市桜区,20,21,1
111074,埼玉県,さいたま市浦和区,28,28,0
111082,埼玉県,さいたま市南区,43,43,0
111091,埼玉県,さいたま市緑区,29,29,0
111104,埼玉県,さいたま市岩槻区,28,28,0
112011,埼玉県,川越市,71,73,2
112020,埼玉県,熊谷市,47,49,2
112038,埼玉県,川口市,138,138,0
112062,埼玉県,行田市,17,17,0
112071,埼玉県,秩父市,2,2,0
112089,埼玉県,所沢市,48,48,0
112097,埼玉県,飯能市,6,6,0
112101,埼玉県,加須市,25,33,8
112119,埼玉県,本庄市,11,11,0
112127,埼玉県,東松山市,22,22,0
112143,埼玉県,春日部市,45,45,0
112151,埼玉県,狭山市,31,31,0
112160,埼玉県,羽生市,1,1,0
112178,埼玉県,鴻巣市,23,23,0
112186,埼玉県,深谷市,8,9,1
112194,埼玉県,上尾市,40,40,0
112216,埼玉県,草加市,56,57,1
112224,埼玉県,越谷市,90,91,1
112232,埼玉県,蕨市,14,14,0
112241,埼玉県,戸田市,34,34,0
112259,埼玉県,入間市,28,28,0
112275,埼玉県,朝霞市,27,28,1
112283,埼玉県,志木市,11,11,0
112291,埼玉県,和光市,18,18,0
112305,埼玉県,新座市,25,27,2
112313,埼玉県,桶川市,15,15,0
112321,埼玉県,久喜市,17,19,2
112330,埼玉県,北本市,11,11,0
112348,埼玉県,八潮市,35,36,1
112356,埼玉県,富士見市,14,14,0
112372,埼玉県,三郷市,19,19,0
112381,埼玉県,蓮田市,14,14,0
112399,埼玉県,坂戸市,18,18,0
112402,埼玉県,幸手市,6,6,0
112411,埼玉県,鶴ヶ島市,18,18,0
112429,埼玉県,日高市,15,16,1
112437,埼玉県,吉川市,11,11,0
112453,埼玉県,ふじみ野市,11,12,1
112461,埼玉県,白岡市,10,10,0
113018,埼玉県,北足立郡伊奈町,8,8,0
113247,埼玉県,入間郡三芳町,8,8,0
113263,埼玉県,入間郡毛呂山町,8,8,0
113417,埼玉県,比企郡滑川町,1,1,0
113425,埼玉県,比企郡嵐山町,3,4,1
113433,埼玉県,比企郡小川町,11,12,1
113468,埼玉県,比企郡川島町,11,11,0
113476,埼玉県,比企郡吉見町,7,7,0
113484,埼玉県,比企郡鳩山町,0,4,4
113620,埼玉県,秩父郡皆野町,1,1,0
113859,埼玉県,児玉郡上里町,5,6,1
114081,埼玉県,大里郡寄居町,0,1,1
114421,埼玉県,南埼玉郡宮代町,9,9,0
114642,埼玉県,北葛飾郡杉戸町,9,9,0
114651,埼玉県,北葛飾郡松伏町,6,6,0
120006,千葉県,,1567,1612,45
121011,千葉県,千葉市中央区,77,77,0
121029,千葉県,千葉市花見川区,46,46,0
121037,千葉県,千葉市稲毛区,47,48,1
121045,千葉県,千葉市若葉区,56,56,0
121053,千葉県,千葉市緑区,31,31,0
121061,千葉県,千葉市美浜区,35,37,2
122025,千葉県,銚子市,23,24,1
122033,千葉県,市川市,121,122,1
122041,千葉県,船橋市,164,165,1
122068,千葉県,木更津市,34,36,2
122076,千葉県,松戸市,99,100,1
122084,千葉県,野田市,37,39,2
122106,千葉県,茂原市,14,16,2
122114,千葉県,成田市,35,37,2
122122,千葉県,佐倉市,32,32,0
122131,千葉県,東金市,17,18,1
122157,千葉県,旭市,17,20,3
122165,千葉県,習志野市,35,35,0
122173,千葉県,柏市,74,77,3
122190,千葉県,市原市,50,54,4
122203,千葉県,流山市,26,29,3
122211,千葉県,八千代市,44,44,0
122220,千葉県,我孫子市,30,30,0
122246,千葉県,鎌ケ谷市,18,18,0
122254,千葉県,君津市,27,28,1
122262,千葉県,富津市,4,5,1
122271,千葉県,浦安市,57,57,0
122289,千葉県,四街道市,17,19,2
122297,千葉県,袖ケ浦市,20,20,0
122301,千葉県,八街市,27,27,0
122319,千葉県,印西市,23,23,0
122327,千葉県,白井市,14,14,0
122335,千葉県,富里市,19,19,0
122351,千葉県,匝瑳市,20,20,0
122360,千葉県,香取市,20,25,5
122378,千葉県,山武市,24,28,4
122386,千葉県,いすみ市,17,17,0
122394,千葉県,大網白里市,21,21,0
123226,千葉県,印旛郡酒々井町,15,15,0
123293,千葉県,印旛郡栄町,8,8,0
123421,千葉県,香取郡神崎町,4,4,0
123471,千葉県,香取郡多古町,1,1,0
123498,千葉県,香取郡東庄町,7,7,0
124036,千葉県,山武郡九十九里町,7,7,0
124095,千葉県,山武郡芝山町,7,6,-1
124109,千葉県,山武郡横芝光町,16,18,2
124214,千葉県,長生郡一宮町,6,6,0
124222,千葉県,長生郡睦沢町,3,4,1
124231,千葉県,長生郡長生村,6,6,0
124249,千葉県,長生郡白子町,5,5,0
124265,千葉県,長生郡長柄町,8,9,1
124435,千葉県,夷隅郡御宿町,2,2,0
130001,東京都,,5046,5168,122
131016,東京都,千代田区,308,312,4
131024,東京都,中央区,199,217,18
131032,東京都,港区,357,369,12
131041,東京都,新宿区,284,289,5
131059,東京都,文京区,122,124,2
131067,東京都,台東区,125,126,1
131075,東京都,墨田区,84,84,0
131083,東京都,江東区,198,205,7
131091,東京都,品川区,187,192,5
131105,東京都,目黒区,84,84,0
131113,東京都,大田区,219,221,2
131121,東京都,世田谷区,278,284,6
131130,東京都,渋谷区,274,278,4
131148,東京都,中野区,110,112,2
131156,東京都,杉並区,137,137,0
131164,東京都,豊島区,141,141,0
131172,東京都,北区,100,100,0
131181,東京都,荒川区,62,62,0
131199,東京都,板橋区,139,139,0
131202,東京都,練馬区,174,176,2
131211,東京都,足立区,189,192,3
131229,東京都,葛飾区,108,108,0
131237,東京都,江戸川区,165,173,8
132012,東京都,八王子市,125,133,8
132021,東京都,立川市,39,42,3
132039,東京都,武蔵野市,29,29,0
132047,東京都,三鷹市,50,50,0
132055,東京都,青梅市,32,33,1
132063,東京都,府中市,48,51,3
132071,東京都,昭島市,20,24,4
132080,東京都,調布市,37,38,1
132098,東京都,町田市,95,96,1
132101,東京都,小金井市,41,42,1
132110,東京都,小平市,50,52,2
132128,東京都,日野市,83,83,0
132136,東京都,東村山市,28,30,2
132144,東京都,国分寺市,27,27,0
132152,東京都,国立市,16,18,2
132187,東京都,福生市,6,8,2
132195,東京都,狛江市,33,35,2
132209,東京都,東大和市,21,21,0
132217,東京都,清瀬市,34,34,0
132225,東京都,東久留米市,22,23,1
132233,東京都,武蔵村山市,16,17,1
132241,東京都,多摩市,59,63,4
132250,東京都,稲城市,12,13,1
132276,東京都,羽村市,10,11,1
132284,東京都,あきる野市,18,19,1
132292,東京都,西東京市,24,24,0
133035,東京都,西多摩郡瑞穂町,11,11,0
133051,東京都,西多摩郡日の出町,5,5,0
133086,東京都,西多摩郡奥多摩町,5,5,0
133647,東京都,神津島村,1,1,0
134210,東京都,小笠原村,5,5,0
140007,神奈川県,,1951,2007,56
141011,神奈川県,横浜市鶴見区,71,72,1
141020,神奈川県,横浜市神奈川区,89,89,0
141038,神奈川県,横浜市西区,86,86,0
141046,神奈川県,横浜市中区,62,62,0
141054,神奈川県,横浜市南区,26,30,4
141062,神奈川県,横浜市保土ケ谷区,48,49,1
141071,神奈川県,横浜市磯子区,23,25,2
141089,神奈川県,横浜市金沢区,58,60,2
141097,神奈川県,横浜市港北区,39,39,0
141101,神奈川県,横浜市戸塚区,56,56,0
141119,神奈川県,横浜市港南区,32,33,1
141127,神奈川県,横浜市旭区,56,58,2
141135,神奈川県,横浜市緑区,44,44,0
141143,神奈川県,横浜市瀬谷区,25,27,2
141151,神奈川県,横浜市栄区,20,20,0
141160,神奈川県,横浜市泉区,24,24,0
141178,神奈川県,横浜市青葉区,46,48,2
141186,神奈川県,横浜市都筑区,33,33,0
141313,神奈川県,川崎市川崎区,121,121,0
141321,神奈川県,川崎市幸区,46,46,0
141330,神奈川県,川崎市中原区,37,37,0
141348,神奈川県,川崎市高津区,65,65,0
141356,神奈川県,川崎市多摩区,32,35,3
141364,神奈川県,川崎市宮前区,26,26,0
141372,神奈川県,川崎市麻生区,26,27,1
141518,神奈川県,相模原市緑区,64,65,1
141526,神奈川県,相模原市中央区,34,35,1
141534,神奈川県,相模原市南区,44,46,2
142018,神奈川県,横須賀市,111,111,0
142034,神奈川県,平塚市,40,40,0
142042,神奈川県,鎌倉市,52,52,0
142051,神奈川県,藤沢市,54,57,3
142069,神奈川県,小田原市,20,24,4
142077,神奈川県,茅ヶ崎市,37,43,6
142085,神奈川県,逗子市,4,5,1
142107,神奈川県,三浦市,9,13,4
142115,神奈川県,秦野市,34,35,1
142123,神奈川県,厚木市,44,45,1
142131,神奈川県,大和市,32,34,2
142140,神奈川県,伊勢原市,19,19,0
142158,神奈川県,海老名市,30,32,2
142166,神奈川県,座間市,47,48,1
142174,神奈川県,南足柄市,6,7,1
142182,神奈川県,綾瀬市,27,28,1
143014,神奈川県,三浦郡葉山町,4,5,1
143219,神奈川県,高座郡寒川町,4,4,0
143413,神奈川県,中郡大磯町,6,6,0
143421,神奈川県,中郡二宮町,5,5,0
143618,神奈川県,足柄上郡中井町,2,3,1
143626,神奈川県,足柄上郡大井町,5,6,1
143642,神奈川県,足柄上郡山北町,1,1,0
143669,神奈川県,足柄上郡開成町,3,4,1
143839,神奈川県,足柄下郡真鶴町,5,5,0
143847,神奈川県,足柄下郡湯河原町,7,7,0
144011,神奈川県,愛甲郡愛川町,9,9,0
144029,神奈川県,愛甲郡清川村,1,1,0
190004,山梨県,,53,57,4
192015,山梨県,甲府市,21,22,1
192023,山梨県,富士吉田市,1,1,0
192082,山梨県,南アルプス市,5,6,1
192104,山梨県,甲斐市,21,22,1
192112,山梨県,笛吹市,1,1,0
192121,山梨県,上野原市,1,1,0
192147,山梨県,中央市,0,1,1
193682,山梨県,南巨摩郡富士川町,3,3,0
